111111
1P0C11
111101
1E0C11
111111
