111111
1P0C11
100011
1C00E1
111111
